NO          ./textures/wallS0.xpm
SO          ./textures/wallS1.xpm
WE          ./textures/wallS2.xpm  
EA          ./textures/wallS3.xpm
DO          ./textures/doorS.xpm

F            25,25,30
C 15,10,25

                    11111111111111111111111111111111111111111111111111111111111111111111111111111111
                    10000000000000000000000000000000000000000000000000000000000000000000000000000001
                    10000000000000000000000000000000000000000000000000000000000000000000000000000001
                    10001111111111111111111111100000000000000000000000111111111111111111111110000001
                    10001000000000000000000001000000000000000000000000000000000000000000001000000001
                    10001000000000000000000001000000000000000000000000000000000000000000001000000001
                    10001000011111111111110001000000000000000000000000000000000000000000001000000001
                    10001000010000000000010001000000001111111111111111111111110000000000001000000001
                    10001000010000000000010001000000001000000000000000000000010000000000001000000001
                    10001000010000000000010001000000001000000000000000000000010000000000001000000001
11111111111111111111110001000010000000000010001000000001000000000000000000000010000000000001000000001111111111111111111111111111111111
10000000000000000000000001000010000000000010001000000001000000000000000000000010000000000001000000000000000000000000000000000000000001
10000000000000000000000001000010000000000010001000000001000000000000000000000010000000000001000000000000000000000000000000000000000001
10000000000000000000000001000010000000000010001000000001111111111111111111111110000000000001000000000000000000000000000000000000000001
10000111111111111111111101000010000000000010001000000000000000000000000000000000000000000001000000000000000000000000000000000000000001
10000100000000000000000001000010000000000010001000000000000000000000000000000000000000000001000000000000000000000000000000000000000001
10000100000000000000000001000011111111111110001000000000000000000000000000000000000000000001000000000000000000000000000000000000000001
10000100000000000000000001000000000000000000001000000000000000000000000000000000000000000001000000000000000000000000000000000000000001
10000100000000000000000001000000000000000000001000000111111111111111111111111111111111111001000000000000000000000000000000000000000001
10000100000000000000000001000000000000000000001000000100000000000000000000000000000000001001000000000000000000000000000000000000000001
10000100000000000000000001111111111111111111111000000100000000000000000000000000000000001001000000000000000000000000000000000000000001
10000100000000000000000000000000000000000000000000000100000000000000000000000000000000001001000000000000000000000000000000000000000001
100001000000000000000000000000000000000000000000000001000111111111111111111D1111111110010010000000000000000000000000000000000000000011
10000100000000000000000000000000000000000000000000000100010000000000100000000000100001001001000000000000000000000000000000000000000001
1000010000000000000000000000000000000000000000000000010001000000000S100000000000100001001001000000000000000000000000000000000000000001
10000100000000000000000000000000000000000000000000000100010000000000000000000000100001001001000000000000000000000000000000000000000001
10000100000000000000000000000000000000000000000000000100010000000000000000000000100001001001000000000000000000000000000000000000000001
10000100000000000000000000000000000000000000000000000100010000000000000000000000100001001001000000000000000000000000000000000000000001
10000100000000000000000000000000000000000000000000000100010000000000000000000000100001001001000000000000000000000000000000000000000001
10000111111111111111111111111111111111111111111111111100010000000000000000000000100001001001000000000000000000000000000000000000000001
10000000000000000000000000000000000000000000000000000000010000000000000000000000100001001001000000000000000000000000000000000000000001
10000000000000000000000000000000000000000000000000000000010000000000000000000000100001001001000000000000000000000000000000000000000001
10000000000000000000000000000000000000000000000000000000010000000000000000000000100001001001111111111111111111111111111111111111110001
10000000000000000000000000000000000000000000000000000000010000000000000000000000100001001000000000000000000000000000000000000000000001
10000000000000000000000000000000000000000000000000000000010000000000000000000000100001001000000000000000000000000000000000000000000001
10000000000000000000000000000000000000000000000000000000010000000000000000000000100001001000000000000000000000000000000000000000000001
10000000000000000000000000000000000000000000000000000000010000000000000000000000100001001000000000000000000000000000000000000000000001
10000000000000000000000000000000000000000000000000000000010000000000000000000000100001001000000000000000000000000000000000000000000001
1111111111111000000000000000000000000000000000000000000000100000000000000000000001000010010010000000000000000000000000000000000000000011111111111
            10000000000000000000000000000000000000000000000000000000010000000000000000000000D00001001000000000000000000000000000000000000000000001
1111111111111000000000000000000000000000000000000000000000100000000000000000000001000010010010000000000000000000000000000000000000000011111111111
10000000000000000000000000000000000000000000000000000000010000000000000000000000100001001000000000000000000000000000000000000000000001
100000000000000000000000000000000000000000000000000000000111111111111111D111111D100001001000000000000000000000000000000000000000000001
100000000000000000000000000000000000000000000000000000000000000000000000000000000000010010000000000000000000000000000000000000000000011
1000000000000000000000000000000000000000000000000000000000000000000000001D10000000000001001000000000000000000000000000000000000000000001
100000000000000000000000000000000000000000000000000000000000000000000000000000000000010010000000000000000000000000000000000000000000011
10000000000000000000000000000000000000000000000000000000000000000000000000000000000001001000000000000000000000000000000000000000000001
10000000000000000000000000000000000000000000000000000000000000000000000000000000000001001000000000000000000000000000000000000000000001
10000000000000000000000000000000000000000000000000000000000000000000000000000000000001001000000000000000000000000000000000000000000001
10000000000000000000000000000000000000000000000000000000000000000000000000000000000001001000000000000000000000000000000000000000000001
10000000000000000000000000000000000000000000000000000000000000000000000000000000000001001000000000000000000000000000000000000000000001
10000000000000000000000000000000000000000000000000000000000000000000000000000000000001001000000000000000000000000000000000000000000001
11111111111111111111111111111111111111111111111111111111111111111111111111111111111111001000000000000000000000000000000000000000000001
                                                                      1001000000000000000000000000000000000000000000001111111111111111
                                                                      1001111111111111111111111111111111111111111111110001
                                                                      1000000000000000000000000000000000000000000000000001
                                                                      1000000000000000000000000000000000000000000000000001
                                                                      1000000000000000000000000000000000000000000000000001
                                                                      1000000000000000000000000000000000000000000000000001
                                                                      1000000000000000000000000000000000000000000000000001
                                                                      1000000000000000000000000000000000000000000000000001
                                                                      1000000000000000000000000000000000000000000000000001
                                                                      1000000000000000000000000000000000000000000000000001
                                                                      1000000000000000000000000000000000000000000000000001
                                                                      1000000000000000000000000000000000000000000000000001
                                                                      1000000000000000000000000000000000000000000000000001
                                                                      1000000000000000000000000000000000000000000000000001
                                                                      1000000000000000000000000000000000000000000000000001
                                                                      1000000000000000000000000000000000000000000000000001
                                                                      1000000000000000000000000000000000000000000000000001
                                                                      1000000000000000000000000000000000000000000000000001
                                                                      1111111111111111111111111111111111111111111111111111