NO          ./textures/north.xpm
SO          ./textures/south.xpm
WE          ./textures/west.xpm  
EA          ./textures/east.xpm
DO          ./textures/door.xpm

F 220,100,0
C 225,30,0

        11111111111111111111111111111111111111111111111111
        11000000000000011000000E00001100000000000011000011
        11000000000000011000000000001100000000000011000011
        11001100110011011001100110011001100110011011001111
1111111111110110111110111101111011111011110111111111111111
1011111111110110111111111101111011111111110111111111111101
1011110111110110111110111101111011111011110111110111110101
1000000000000000000000000001000000000000000000000000000001
1011110111111111111111111111111111111111111111110111110101
1011110111111111111111111111111111111111111111110111110101
1011110110111111111111111111111111111111111111110111110101
1000000110000110000110000001000000110000110000110000000001
1000000110000110000110000001000000110000110000110000000001
1011110110000000000110111101111111110000000000110111110101
1011110110011001110110111101111111110011001110110111110111
1000000010100000010110000001000000010100000010110000000001
1000000110100000110110000001000000110100000110110000000001
1011110110111111110110111101111111110111111110110111110101
1011110110000000000110111101111111110000000000110111110101
1000000110000110000110000001000000110000110000110000000001
1011110110111111110110111101111111110111111110110111110101
1111111111111111111111111111111111111111111111111111111111
        11111111111111111111111111111111111111111111111111
        11000000000000011000000000001100000000000011000011
        11000000000000011000000000001100000000000011000011
1111111111110110111110111101111011111011110111111111111111
1011111111110110111111111101111011111111110111111111111101
1011110111110110111110111101111011111011110111110111110101
1000000000000000000000000000000000000000000000000000000001
1011110111111111111111111100111111111111111111110111110101
1011110111111111111111111110111111111111111111110111110101
1111111111111111111111111110111111111111111111111111111111
1011110110111111111111111110111111111111111111110111110101
1000000110000110000110000000000000110000110000110000000001
1000001110001110001110001111000001110001110001110000000111
1011110110000000000110111101111111110000000000110111110101
101111011001100111011011110111111111001100111011011111011D1
1000000110100000010110000001000000110100000010110000000001
1000000110100000110110000001000000110100000110110000000001
1011110110111111110110111101111111110111111110110111110101
1011110110000000000110111101111111110000000000110111110101
1000000110000110000110000001000000110000110000110000000001
1011110110111111110110111101111111110111111110110111110101
1111111111111111111111111111111111111111111111111111111111
        11111111111111111111111111111111111111111111111111
        11000000000000011000000000001100000000000011000011
        11000000000000011000000000001100000000000011000011
1111111111110110111110111101111011111011110111111111111111
1011111111110110111111111101111011111111110111111111111101
1011110111110110111110111101111011111011110111110111110101
1000000000000000000000000001000000000000000000000000000001
1011110111111111111111111111111111111111111111110111110101
1011110111111111111111111111111111111111111111110111110101
1011110110111111111111111111111111111111111111110111110101
1000000110000110000110000001000000110000110000110000000001
1000000110000110000110000001000000110000110000110000000001
1011110110000000000110111101111111110000000000110111110101
1011110110011001110110111101111111110011001110110111110111
1000000010100000010110000001000000010100000010110000000001
1000000110100000110110000001000000110100000110110000000001
1011110110111111110110111101111111110111111110110111110101
1011110110000000000110111101111111110000000000110111110101
1000000110000110000110000001000000110000110000110000000001
1011110110111111110110111101111111110111111110110111110101
1111111111111111111111111111111111111111111111111111111111