NO          ./textures/wallS0.xpm
SO          ./textures/wallS1.xpm
WE          ./textures/wallS2.xpm  
EA          ./textures/wallS3.xpm
DO          ./textures/doorS.xpm

F 220,100,0
C 225,30,0

        1111111111111111111111111111
        1100000000000110000000000011
111111111111011011111011110111111111
1011111111110110111111111101
1011110111110110111110111101
1000000000000000000000000001
1011110111111111111111111111
11111111111
1011110110111111111111111111
1000000110000110000110000001
100000011001011000011000000111
1011110110000000000110111101101
1111111110E110011101101111011111111
        1000000010100000010110000001
11111111111010000011011000000111111
10111101101111111101101111011
1111110110000000000110111101
1000000110000110000110000001
1011110110111111110110111101
11111111111111111111111111111
        11111111111111111111111111111111111
                11100000000000110000000000011
1111111111111111111110111101111111111111111
1011111111110110111111111101
1011110111110110111110111101
1000000000000000000000000001
1011110111111111111111111111
11111111111
1011110110111111111111111111
1000000110000110000110000001
100000011000011000011000000111
1011110110000000000110111101101
101111011001001110110111101111
1000000110100000010110000001
1000000110100000110110000001
1011110110111111110110111101
1011110110000000000110111101
1000000110000110000110000001
1011110110111111110110111101
1111111111111111111111111111