NO          ./textures/north.xpm
SO          ./textures/south.xpm
WE          ./textures/west.xpm  
EA          ./textures/east.xpm
DO ./textures/door.xpm

F 220,100,0
C 225,30,0

1111111111111111111111111111
1100000000000110000000000011
1011110111110110111110111101
1011111111110110111111111101
1011110111110110111110111101
1000000000000000000000000001
1011110110111111110110111101
1011110110111111110110111101
1000000110000110000110000001
1000000110000110000110000001
1011110110000000000110111101
1011110110N11001110110111101
1000000110100000010110000001
1000000110100000110110000001
1011110110111111110110111101
1011110110000000000110111101
1000000110000110000110000001
1011110110111111110110111101
1111111111111111111111111111